*неопределенный артикль a/an
предмет (объект, явление) упоминается впервые	a
предмет является представителем своего класса в значении "один", "любой"	a
когда мы говорим о вещах в целом (__ airplane is faster than __ train. (in general))	a
часто используется после "to be" и "have/have got" (He has got __ camera)	a
существительное является именной частью составного сказуемого (What you see here is __ phonograph)	a
в восклицательных предложениях со словами what/such	a
перед исчисляемыми существительными в единственном числе со словами such, quite, rather	a
при обозначении парных слов (__ mother and __ father)	a
для обозначения количества (__ couple of, __ half of, half __ pound)	a
для выражении единицы меры (__ half of, half __ pound)	a
для выражения единичности (It happend __ moment ago)	a
в определении предмета или объекта	a
с именами собственными в значении "некий", "некто", "какой-то"	a
с именами собственными в значении "похожий на", "точно как другой человек", "настоящий __ (в сравнении)"	a
с именами собсвенными в значении - продукт чьего-то творчества (An anonnymous bidder bought __ Picasso at the auction yesterday)	a
в устойчивых выражениях (He is __ real doubting Thomas)	a

*a или an в зависимости от первого звука
	an honest person
	an hour
	a euro
	a uniform

*определенный артикль the
объект о котором знают оба собеседника	the
объект который упоминается во второй и более раз	the
используется, когда речь идет о каком-либо конкретном объекте	the
объект имеет конкретный смысл в известном контексте (__ tsunami victims were all placed in temporary camps)	the
в предложении есть конкретизирующая деталь	the
объект представляет собой новое изобретение	the
объект имеет коллективный, обобщающий или собирательный смысл (We must be merciful to __ poor and __ needy. I like __ beautiful)	the
обозначает высший пост без указания имени человека	 the
обозначаются обширные территории	the
используется с превосходной степенью	the
время суток с предлогом in	the
для обозначения определенного времени	the
с общеизвестными местами	the
названия музыкальных инструментов, танцев	the
для обозначения рода деятельности (on __ radio, __ media)	the
названия частей тела	the
экстренные службы	the
собирательная группа людей с окончанием -sh, -ch, -ese	the
собирательная группа людей без специфического окончания	the/none
имя человека в значении "тот самый", "известный"	the
собирательная группа людей обозначающаяся фамилией	the
основные географические направления, стороны света	the
имена собственные с предлогом of	the
вместе со словами next и last если говорится о периоде времени НЕ близком к моменту разговора	the
названия рек	the
названия каналов	the
названия групп островов	the
названия штатов	the
названия горных гряд	the
названия пустынь	the
названия океанов	the
названия театров	the
названия музеев	the
названия галерей	the
названия ресторанов	the
названия некоторых газед	the
названия кораблей	the
названия некоторых фильмов	the
названия уникальных объектов	the

*конкретные примеры использования the
in	the mountains
at	the seaside
in	the country
on	the beach
	the cinema
	the theater
	the radio
	the country(side)
	the seaside
	the beach
	the world
	the weekend
	the shop
	the library
	the city
	the village
	the sun
	the world
	the moon
	the environment

*использование нулевого артикля
с неисчисляемыми существительными	none
c абстрактными существительными (__ advise, __ information, __ fun, __ luck)`	none
слова обозначающие трапезу как церемонию	none
если перед существительным стоит отрицательная частица	none
название игры	none
существительное обозначает общественный институт (не его помещение!)	none
название болезни	none
существительное, обозначающее время или событие с предлогом at	none
существительное определяется следующим за ним количественным числительным (on __ platform 11, in __ room 7)	none
существительное используется в заголовках, записках, объявления, кратких инструкциях	none
существительное следует за местоиммением или другим определителем	none
home когда мы говорим о собственном доме	none
father/mother	когда мы говорим особственных родителях	none
титулы с именами собственными	none
после слов next и last если говорится о периоде времени близком к моменту разговора	none
сопособ передвижения с предлогом by	none
название спорта	none
название активности	none
название цвета	none
название субстанции	none
название блюда	none
названия стран	none
названия городов	none
названия улиц	none
названия парков	none
названия гор	none
названия островов	none
названия озер	none
названия континентов	none
названия планет	none
названия железнодорожных станций	none
названия континентов	none
названия аэропортов	none
названия компаний	none
названия торговых центров	none
названия банков	none
аббревиатуры	none
название праздника	none
названия языка мира	none
название дней недели	none
названия месяцев	none
названия лет	none
прилагательные, основанные на именах собственных указывающие принадлежность	none
become __ King	none
he's __ English	none
speaks __ English	none
at __ work	none

*используется как a так и the
перед исчисляемыми существительными в единственном числе для обозначения класса людей, биологического вида или разновидности людей	a/the